.................1111111
.................1.....1
.................1.P...1
.................1.....1
.................1.....1
.................1.....1
.................1.....1
.................1.....1
.................1.....1
.................1.....1
.................1.....1
.................1.....1
.................1.....1
.................1.....1
.................1.....1
.................1.....1
.................1.....1
.................1.....1
.................1.....1
.................1.....1
.................1.....1
.................1.....1
.................1.....1
.................1.....1
.................1.....1
.................1.E...1
.................1.....1
.................1.....1
.................1111111