..................111111
..................1E...1
..................1....1
..................1....1
..................1....1
..................1....1
..................1....1
..................1....1
..................1....1
..................1....1
..................1....1
..................1....1
..................1....1
..................1....1
..................1....1
..................1....1
..................1....1
..................1....1
..................1....1
..................1....1
..................1.P..1
..................1....1
..................1....1
..................111111