.............11111111111
.............1.........1
.............1.........1
.............1.........1
.............1.C.......1
.............1....1....1
.............1....1....1
.............1....1....1
.............1....1....1
.............1....1....1
.............1....1....1
.............1....1....1
.............1....1....1
.............1....1....1
.............1....1....1
.............1....1....1
.............1....1....1
.............1....1....1
.............1....1....1
.............1....1....1
.............1.E..1.P..1
.............1....1....1
.............1....1....1
.............11111111111